10
10
10
xxxxxxxxxxxxxxxxxxxx
x??????????????????x
x????????t?????????x
x???????ooo????????x
x???????ooo????????x
x???s???ooo????????x
x???????ooo????????x
x????????t?????????x
xs?????????????????x
xxxxxxxxxxxxxxxxxxxx