9
3
3
    xxxxxxxxx
    xo??..?ox
    x?m....?x
    x?...r.?x
    xt....b?x
    xt??..?ox
    xxxxxxxxx
             
              