10
7
0
      xxxxxxxx
      x.b..m.x
      x......x
xxxxxxx......xxxxxxx
x...s..........s...x
x........tt........x
xxxxxxx......xxxxxxx
      x......x
      x...r..x
      xxxxxxxx