10
6
6
    xxxxxxxxxxxx
    x??????????x
    xx...t....xx
     xx......xx
      x....s.x
      x.s....x
     xx......xx
    xx....t...xx
    x??????????x
    xxxxxxxxxxxx