10
6
6
    xxxxxxxxxxxx
    x??????????x
    xx...t....xx
     xx......xx
      xm...sbx
      x.s....x
     xxr.....xx
    xx....t...xx
    x??????????x
    xxxxxxxxxxxx