10
6
6
xxxxxxxxxxxxxxxxxxxx
x?..????????????..?x
xxx..t........t..xxx
  xx......s.....xx
   x...m....b...x
   x.....s......x
  xx............xx
xxx......r.......xxx
x?..????????????..?x
xxxxxxxxxxxxxxxxxxxx